###############################################################################################################################################################
#                                                                                                                                                             #
#                                                                                                                                                             #
#                                                                                                                                                             #
#                                      ##               ##              ########                                                                              #
#                                      ##               ##            ##        ##                                                                            #
#                                      ##               ##           ##          ##                                                                           #
#                                      ##               ##          ##            ##                                                                          #
#                                       ##             ##          ##              ##                                                                         #
#                                        ##           ##          ##                ##                                                                        #
#                                         ##         ##           ##                ##                                                                        #
#                                          ##       ##            ##                ##                                                                        #
#                                           #########             ##                ##                                                                       #
#                                              ###                ##                ##                                                                        #
#                                              ###                 ##              ##                                                                         #
#                                              ###                  ##            ##                                                                          #
#                                              ###                   ##          ##                                                                           #
#                                     ^        ###                    ##        ##                                                                            #
#                                    ^ ^       ###                      ########                                                                              #
#                                                                                                                                                             #
#                                                                                                                                                             #
#                                                                                                                                                             #
#                                                                                                                                                             #
#                                                                                                                                                             #
#                                                                                                                                                             #
#                                                                                                                                                             #
#                                                                                                                                                             #
#                                                                                                                                                             #
#                                                                                                                                                             #
#                                                                                                                                                             #
#                                                                                                                                                             #
#                                                                                                                                                             #
#                                                                                                                                                             #
#                                                                                                                                                             #
#                                                                                                                                                             #
#                                                                                                                                                             #
#                                                                                                                                                             #
#                                                                                                                                                             #
#                                                                                                                                                             #
#                                                                                                                                                             #
#                                                                                                                                                             #
#                                                                                                                                                             #
#                                                                                                                                                             #
#                                                                                                                                                             #
#                                                                                                                                                             #
#                                                                                                                                                             #
#                                                                                                                                                             #
#                                                                                                                                                             #
#                                                                                                                                                             #
###############################################################################################################################################################