###############################################################################################################################################################
#                                                                                                                                                             #
#                                                                                                                                                             #
#                                                                                                                                                             #
#                                                                                                                                                             #
#                                       1                                                                                                                     #
#                                                                                                                                                             #
#                                                                                                                                                             #
#                                                                       4                                                                                     #
#                                                                                                                                                             #
#                                                                                                                                                             #
#                                                         7                                                                                                   #
#                                                                                                                                                             #
#                                  2                                                                                                                          #
#                                                                                    3                                                                        #
#                                                                                                                                                             #
#                                                                                                                                                             #
#                                                                                                                                                             #
#                                                                                                                                                             #
#                                                        5                                                                                                    #
#                                                                                               6                                                             #
#                                                                                                                                                             #
#                                                                                                                                                             #
#                                                                                                                                                             #
#                                                                                                                                                             #
#                                                                                                                                                             #
#                                                                                                                                                             #
#                                                                                                                                                             #
#                                                                                                                                                             #
#                                                                                                                                                             #
#                                                                                                                                                             #
#                                                                                                                                                             #
#                                                                                                                                                             #
#                                                                                                                                                             #
#                                                                                                                                                             #
#                                                                                                                                                             #
#                                                                                                                                                             #
#                                                                                                                                                             #
#                                                                                                                                                             #
#                                                                                                                                                             #
#                                                                                                                                                             #
#                                                                                                                                                             #
#                                                                                                                                                             #
#                                                                                                                                                             #
#                                                                                                                                                             #
#                                                                                                                                                             #
#                                                                                                                                                             #
#                                                                                                                                                             #
#                                                                                                                                                             #
###############################################################################################################################################################