####################                                     #######################
#####                                                                &&&   #####
####  &&&                                                            &&&    ####
###   &&&                                                            &&&     ###
##    &&&                                                                     ##
#                                                                              #
#                                                                               
#                                                                               
#                                                                               
#                                   ##                                          
#                                  ####                                         
#                                 ##@@##                                        
#     &&&                                                                       
#     &&&                                                                       
#     &&&                                                                       
#                                                                               
#                                                                               
#                                                         &&&                   
#                        &&&                              &&&                   
#                        &&&                              &&&                  #
##                       &&&                                                  ##
###                                                                          ###
####                                                                        ####
#####                                                                      #####
################################################################################