####################                                     #######################
#                                                                           ####
#                                                                            ###
#                                                                             ##
#                                                                             ##
#                                                                              #
#                                                                               
#                                                                               
#                                                                               
#                                   ##                                          
#                                  ####                                         
#                                 ##@@##                                        
#                                                                               
#                                                                               
#                                                                               
#                                                                               
#                                                                               
#                                                                               
#                                                                               
#                                                                              #
#                                                                             ##
#                                                                             ##
#                                                                            ###
#                                                                           ####
################################################################################