&&&&&###########################################################################
&&&&&^^^^^^^^^^^^^^^^^^####                                                #####
&&&&^^^^^^^^^^^^^^^^^^^^####                                                ####
&&&^^^^^^^^^^^^^^^^^^^^^^####                                                ###
&&^^^^^^^^^^^^^^^^^^^^^^^^####                                                ##
&^^^^^^^^^^^^^^^^^^^^^^^^^^####                &&&&                            #
&^^^^^^^^^^^^^^^^^^^^^^^^^^^###                &&&&                             
&#^^^^^^^^^^^^^^^^^^^^^^^^^^^##                                                 
&##^^^^^^^^^^^^^^^^^^^^^^^^^###                                                 
&###^^^^^^^^^^^^^^^^^^^^^^^###                                                  
&####^^^^^^^^^^^^^^^^^^^^^###                               &&&&                
&#####^^^^^^^^^^^^^^^^^^####       ##                       &&&&                
&#########################        ####                                          
&#                               ##@@##                                         
&#                                                                              
&#                                                                              
&#                          &&&&                                                
&#                          &&&&                                                
&#         &&&&                                                                 
&#         &&&&                                            &&&&                #
&&#                                                        &&&&               ##
&&&#                                                                         ###
&&&&#                                                                       ####
&&&&&#                                                                     #####
####################                                     #######################