####################        &&&&                         #######################
#####################       &&&&                                           #####
######################                                                      ####
#######################                                                      ###
########################                                                      ##
#######################################################################        #
        ####################^^^^^^^^^^^^^^^#                                   #
         ###################^^^^^^^^^^^^^^^#                       &&&&        #
          ##################^^^^^^^^^^^^^^^#                       &&&&        #
                         ###^^^^^^^^^^^^^^^#           &&&&                    #
                          ##^^^^^^^^^^^^^^^#           &&&&                    #
                           #################                                   #
                                                                   &&&&        #
                           #################                       &&&&        #
                          ##^^^^^^^^^^^^^^^#                                   #
                         ###^^^^^^^^^^^^^^^#              &&&&                 #
           #################^^^^^^^^^^^^^^^#              &&&&                 #
          ##################^^^^^^^^^^^^^^^#                                   #
         ###################^^^^^^^^^^^^^^^#                                   #
#######################################################################        #
########################                                                      ##
#######################                    &&&&                              ###
######################                     &&&&                             ####
#####################                                                      #####
####################                                     #######################