####################                                     #######################
#####                                                                      #####
####                                                                        ####
###                                                                          ###
##                                                                            ##
#                                                                              #
#                                                                               
#                                                                               
#                                                                               
#                                   ##                                          
#                                  ####                                         
#                                 ##@@##                                        
#                                                                               
#                                                                               
#                                                                               
#                                                                               
#                                                                               
#                                                                               
#                                                                               
#                                                                              #
##                                                                            ##
###                                                                          ###
####                                                                        ####
#####                                                                      #####
################################################################################