####################                                     #######################
#####                                                                      #####
####                                                                        ####
###                                                                          ###
##                                                                            ##
#                                                                              #
                                                                               #
                        ###################                                    #
                        ###################                                    #
                        ####                                                   #
                        ####  &  ##  &                                         #
                        ####  & #### &                                         #
                        ####   ##@@##                                          #
                        ####                                                   #
                        ####                                                 &&#
                        ####                                ####################
                        ####                                #^^^^^^^^^^^^^^^^^^#
^                       ####                                #^^^^^^^^^^^^^^^^^^#
                        ####                                #^^^^^^^^^^^^^^^^^^#
#                       ####                                #^^^^^^^^^^^^^^^^^^#
##                      ####                                #^^^^^^^^^^^^^^^^^##
###                     ####                                #^^^^^^^^^^^^^^^^###
####                    ####                               &#^^^^^^^^^^^^^^^####
#####                   ####                               &#^^^^^^^^^^^^^^#####
################################################################################