&&&&&###########################################################################
&&&&&^^^^^^^^^^^^^^^^^^^^^^^^^#                                            #####
&&&&^^^^^^^^^^^^^^^^^^^^^^^^^^#                                             ####
&&&^^^^^^^^^^^^^^^^^^^^^^^^^^^#                                              ###
&&^^^^^^^^^^^^^^^^^^^^^^^^^^^^#                                               ##
&^^^^^^^^^^^^^^^^^^^^^^^^^^^^^#                &&&&                            #
&^^^^^^^^^^^^^^^^^^^^^^^^^^^^^#                &&&&                             
&^^^^^^^^^^^^^^^^^^^^^^^^^^^^^#                                                 
&^^^^^^^^^^^^^^^^^^^^^^^^^^^^^#                                                 
&^^^^^^^^^^^^^^^^^^^^^^^^^^^^^#                                                 
&^^^^^^^^^^^^^^^^^^^^^^^^^^^^^#                             &&&&                
&^^^^^^^^^^^^^^^^^^^^^^^^^^^^^#    ##                       &&&&                
&##############################   ####                                          
&#                               ##@@##                                         
&#                                                                              
&#                                                                              
&#                          &&&&                                                
&#                          &&&&                                                
&#         &&&&                                                                 
&#         &&&&                                            &&&&                #
&&#                                                        &&&&               ##
&&&#                                                                         ###
&&&&#                                                                       ####
&&&&&#                                                                     #####
####################                                     #######################