####################                                     #######################
#####                                                                &&    #####
####  &&                             &&  &&                          &&&    ####
###   &&&&             &&&             &&&&                         &&&&&    ###
##     &&             &&&&&            & &                            &       ##
#                    &&&&&                                                     #
#                                                                               
#                                                                               
#          &&& &&                                          &                    
#           &  &                    ##                  &&&&                    
#           &&&&                   ####                &&&&                     
#                                 ##@@##                &&&&                    
#     &&& &                                                                     
#     &&&&&                                                                     
#     & &&                                                                      
#                                                                               
#                                                                               
#                                                         &&&                   
#                        &&&                             && &                   
#                       &&&&&                             &&&&                 #
##                       &&&                                                  ##
###                                                                          ###
####                                                                        ####
#####                                                                      #####
################################################################################