################################################################################
#####                                                                      #####
####                                                                        ####
###                                                                          ###
##                                                                            ##
#                      ###############################                         #
                       ###^^^^^^^^^^^^^^^^^^^^^^^^^###                          
                       ###^^^&&&^^^^^^^^^^^^^&&&^^^###                          
                       ###^^^&&&^^^^^^^^^^^^^&&&^^^###                          
                       ###^^^^^^^^^^^^^^^^^^^^^^^^^###                          
                       ###^^^^^^^^^^^^^^^^^^^^^^^^^###                          
                       ###^^^&^^^^^^^^^^^^^^^^^&^^^###                          
                       ###^^^^&^^^^^^^^^^^^^^^&^^^^###                          
                       ###^^^^^&^^^^^^^^^^^^^&^^^^^###                          
                       ###^^^^^^&&&&&&&&&&&&&^^^^^^###                          
                       ###^^^^^^^^^^^^^^^^^^^^^^^^^###                          
                       ###############################                          
                                                                                
                                                                                
#                                                                              #
##                                                                            ##
###                                                                          ###
####                                                                        ####
#####                                                                      #####
####################                                     #######################