################################################################################
#####                                                                      #####
####                                                                        ####
###                                                                          ###
##                                                                            ##
#                                                                              #
#                                                                               
#                                                                               
#                                                                               
#                                                                               
#                                                                               
#                                  ##                                           
#                                 ####                                          
#                                ##@@##                                         
#                                                                               
#                                                                               
#                                                                               
#                                                                               
#                                                                               
#                                                                              #
##                                                                            ##
###                                                                          ###
####                                                                        ####
#####                                                                      #####
####################                                     #######################