################################################################################
#####                 ###########        ##########                        #####
####      &           ###########        ##########                         ####
###                   ###########        ##########                          ###
##                    ###########        ##########                           ##
#               &     ###########        ##########           &                #
                      ###########        ##########                            #
                      ###########        ##########              &             #
            &         ###########        ##########                            #
                      ###########        ##########                            #
                      ###########   ##   ##########                            #
                      ###########  ####  ##########          &                 #
                      ########### ##@@## ##########                            #
                      ###########        ##########                            #
                      ###########        ##########                            #
                      ###########        ##########                            #
                      ###########        ##########                            #
                      ###########        ##########                            #
                                                                               #
#                                                                              #
##                                                                            ##
###                                                                          ###
####                                                                        ####
#####                                                                      #####
####################                                     #######################