####################                                     #######################
#####           ####                                                       #####
####   &&&      ####                                                        ####
###    &&&      ####                                                         ###
##     &&&      ####                                                          ##
#               ####                                                           #
                ####                                                &&&         
                ####                                                &&&         
                ####                                                &&&         
                ####                                                            
                ####                                                            
                ###############################################                 
                ###############################################                 
                ###############################################                 
                ###############################################                 
                       &&&&&&&&&&&&&&&&&&&&&&&&&&&&&&                           
                                                                                
                                                                                
                                                                                
#                                                                              #
##                                                   &&&                      ##
###                                                  &&&                     ###
####                                                 &&&                    ####
#####                                                                      #####
################################################################################