################################################################################
#####                 ###########^^^^^^^^##########                        #####
####      &           ###########^^^^^^^^##########      &        &         ####
###                   ###########^^^^^^^^##########                          ###
##                    ###########^^^^^^^^##########                           ##
#               &     ###########^^^^^^^^##########           &                #
                      ###########^^^^^^^^##########                            #
                      ###########^^^^^^^^##########              &             #
            &         #############################                            #
                      ###########        ##########                            #
                      ###########   ##   ##########                            #
                      ###########  ####  ##########          &     &           #
                      ########### ##@@## ##########                            #
        &             ###########        ##########                            #
                      ###########        ##########                            #
                      ###########        ##########                            #
                &     ###########        ##########              &             #
                      ###########        ##########                            #
                                                                               #
#                                                                              #
##                                                                            ##
###                                                                          ###
####                                                                        ####
#####                                                                      #####
####################                                     #######################