####################&                                    #######################
#####^^^^^^^^^######&                                                      #####
####^^^^^^^^^^######&                                &&&                    ####
###^^^^^^^^^^^######&                                &&&                     ###
##^^^^^^^^^^^^######&                                                         ##
#^^^^^^^^^^^^^######&              &&&                                         #
#^^^^^^^^^^^^^######&              &&&                                          
#^^^^^^^^^^^^^######&                                                           
#^^^^^^^^^^^^^######&                                                           
#^^^^^^^^^^^^^######&                                   &#######                
#^^^^^^^^^^^^^######&                                   &#######                
#^^^^^^^^^^^^^######&                                   &#######                
#^^^^^^^^^^^^^######&                                   &#######                
#^^^^^^^^^^^^^######&                                   &#######                
#^^^^^^^^^^^^^######&                         &&&       &#######                
#^^^^^^^^^^^^^######&                         &&&       &#######                
#^^^^^^^^^^^^^######&                                   &#######                
#^^^^^^^^^^^^^######&                                   &#######                
#^^^^^^^^^^^^^######&            &&&                    &#######                
#^^^^^^^^^^^^^######&            &&&                    &#######               #
##^^^^^^^^^^^^######&                                   &#######              ##
###^^^^^^^^^^^######&                                   &#######             ###
####^^^^^^^^^^######&                                   &#######            ####
#####^^^^^^^^^######&                                   &#######           #####
####################&                                   &#######################