####################                                     #######################
#####     &     ####                                                       #####
####   &&&      ####                                                        ####
###    & &&     ####                                                         ###
##     &&&      ####                                                          ##
#         &     ####                                               &           #
                #####                                               &&&         
                ######                                             &&  &        
                #######                                             &&&         
                ########                                               &        
                #########                                                       
                #############################################                   
                  #############################################                 
                   ###########################################                  
                     ########################################                   
                       &&&&&&&&&&        &&&&&&&&&&&                            
                           &&                    &&                             
                           &&&                   &&                             
                            &&&                   &                             
#                             &         &                                      #
##                                     &&            &&& &                    ##
###                                   &&            &&&&&                    ###
####                                  &&             &&& &                  ####
#####                                &&              &                     #####
################################################################################