####################                                     #######################
#####                                                                      #####
####                                                                        ####
###                                                                          ###
##                                                                            ##
#                                                                              #
                                                                               #
                          ################                                     #
                         ##################                                    #
                        ####                                                   #
                        ####  &  ##  &                                         #
                        ####  & #### &                                         #
                        ####   ##@@##                                          #
                       ####                                                    #
                       ####                                                  &&#
                       ###                                      ################
                       ####                                   ##################
                        ####                                 ###^^^^^^^^^^^^^^^#
                        ####                                ###^^^^^^^^^^^^^^^^#
#                       #####                               ##^^^^^^^^^^^^^^^^^#
##                      ######                              ##^^^^^^^^^^^^^^^^##
###                     #######                             ##^^^^^^^^^^^^^^^###
####                     #######                           &##^^^^^^^^^^^^^^####
#####                     #######                          &##^^^^^^^^^^^^^#####
################################################################################