####################                                     #######################
#####           ####                                                       #####
####            ####                                                        ####
###             ####                                                         ###
##              ####                                                          ##
#               ####                                                           #
                ####                                                            
                ####                                                            
                ####                                                            
                ####                                                            
                ####                                                            
                ###############################################                 
                ###############################################                 
                ###############################################                 
                ###############################################                 
                       &&&&&&&&&&&&&&&&&&&&&&&&&&&&&&                           
                                                                                
                                                                                
                                                                                
#                                                                              #
##                                                                            ##
###                                                                          ###
####                                                                        ####
#####                                                                      #####
################################################################################