################################################################################
#####                  ############################                        #####
####      &            ###########^^^^^^###########      &        &         ####
###                    ##########^^^^^^^^##########                          ###
##                     ##########^^^^^^^^##########                           ##
#               &      ##########^^^^^^^^##########           &                #
                       ###########^^^^^^###########                            #
                       ############^^^^############              &             #
            &          ############################                            #
                       ##########        ##########                            #
                       ##########   ##   ##########                            #
                       ##########  ####  ##########          &     &           #
                       ########## ##@@## ##########                            #
        &               #########        #########                             #
                        #########        #########                             #
                         # ######        ###### #                              #
                &           #####        #####                   &             #
                             ####        ####                                  #
                                                                               #
#                                                                              #
##                                                                            ##
###                                                                          ###
####                                                                        ####
#####                                                                      #####
####################                                     #######################