################################################################################
#####                                                                      #####
####                                                                        ####
###                                                                          ###
##                                                                            ##
#                                                                              #
                                                                                
                             &&&             &&&                                
                             &&&             &&&                                
                                                                                
                                                                                
                             &                 &                                
                              &               &                                 
                               &             &                                  
                                &&&&&&&&&&&&&                                   
                                                                                
                                                                                
                                                                                
                                                                                
#                                                                              #
##                                                                            ##
###                                                                          ###
####                                                                        ####
#####                                                                      #####
####################                                     #######################