####################                                     #######################
#####                                                                      #####
####                                                                        ####
###                                                                          ###
##                                                                            ##
#                                                                              #
                                                                               #
                        ###################                                    #
                        ###################                                    #
                        ####                                                   #
                        ####  &  ##  &                                         #
                        ####  & #### &                                         #
                        ####   ##@@##                                          #
                        ####                                                   #
                        ####                                                   #
                        ####                                                   #
                        ####                                                   #
                        ####                                                   #
                        ####                                                   #
#                       ####                                                   #
##                      ####                                                  ##
###                     ####                                                 ###
####                    ####                                                ####
#####                   ####                                               #####
################################################################################