####################&                                    #######################
#####         ######&                                                      #####
####          ######&                                                       ####
###           ######&                                                        ###
##            ######&                                                         ##
#             ######&                                                          #
#             ######&                                                           
#             ######&                                                           
#             ######&                                                           
#             ######&                                   &#######                
#             ######&                                   &#######                
#             ######&                                   &#######                
#             ######&                                   &#######                
#             ######&                                   &#######                
#             ######&                                   &#######                
#                                                       &#######                
#                                                       &#######                
#                                                       &#######                
#                                                       &#######                
#                                                       &#######               #
##                                                      &#######              ##
###                                                     &#######             ###
####                                                    &#######            ####
#####                                                   &#######           #####
####################                                    &#######################