###########################################################################################
#\#\#\#\#\#\#\#\#\#\#\#\#\#\#\                               /#\#\#\#\#\#\#\#\#\#\#\#\#\#\#
#/#/#/#/#/#/#/#/#/#/#/#/#/#/# \                             / #/#/#/#/#/#/#/#/#/#/#/#/#/#/#
#\#\#\#\#\#\#\#\#\#\#\#\#\#\#  \                           /  #\#\#\#\#\#\#\#\#\#\#\#\#\#\#
#/#/#/#/#/#/#/#/#/#/#/#/#/#/#   \                         /   #/#/#/#/#/#/#/#/#/#/#/#/#/#/#
#\#\#\#\#\#\#\#\#\#\#\#\#\#\#    \                       /    #\#\#\#\#\#\#\#\#\#\#\#\#\#\#
#/#/#/#/#/#/#/#/#/#/#/#/#/#/#     \                     /     #/#/#/#/#/#/#/#/#/#/#/#/#/#/#
#\#\#\#\#\#\#\#\#\#\#\#\#\#\#      \                   /      #\#\#\#\#\#\#\#\#\#\#\#\#\#\#
#/#/#/#/#/#/#/#/#/#/#/#/#/#/#       \                 /       #/#/#/#/#/#/#/#/#/#/#/#/#/#/#
#\#\#\#\#\#\#\#\#\#\#\#\#\#\#        \               /        #\#\#\#\#\#\#\#\#\#\#\#\#\#\#
#/#/#/#/#/#/#/#/#/#/#/#/#/#/#         \             /         #/#/#/#/#/#/#/#/#/#/#/#/#/#/#
#\#\#\#\#\#\#\#\#\#\#\#\#\#\#          \           /          #\#\#\#\#\#\#\#\#\#\#\#\#\#\#
#/#/#/#/#/#/#/#/#/#/#/#/#/#/#           \         /           #/#/#/#/#/#/#/#/#/#/#/#/#/#/#
#\#\#\#\#\#\#\#\#\#\#\#\#\#\#            \       /            #\#\#\#\#\#\#\#\#\#\#\#\#\#\#
#/#/#/#/#/#/#/#/#/#/#/#/#/#/#             \     /             #/#/#/#/#/#/#/#/#/#/#/#/#/#/#
#\#\#\#\#\#\#\#\#\#\#\#\#\#\#              \   /              #\#\#\#\#\#\#\#\#\#\#\#\#\#\#
#/#/#/#/#/#/#/#/#/#/#/#/#/#/#               \ /               #/#/#/#/#/#/#/#/#/#/#/#/#/#/#
#\#\#\#\#\#\#\#\#\#\#\#\#\#\#----------------X----------------#\#\#\#\#\#\#\#\#\#\#\#\#\#\#
#/#/#/#/#/#/#/#/#/#/#/#/#/#/#               / \               #/#/#/#/#/#/#/#/#/#/#/#/#/#/#
#\#\#\#\#\#\#\#\#\#\#\#\#\#\#              /   \              #\#\#\#\#\#\#\#\#\#\#\#\#\#\#
#/#/#/#/#/#/#/#/#/#/#/#/#/#/#             /     \             #/#/#/#/#/#/#/#/#/#/#/#/#/#/#
#\#\#\#\#\#\#\#\#\#\#\#\#\#\#            /       \            #\#\#\#\#\#\#\#\#\#\#\#\#\#\#
#/#/#/#/#/#/#/#/#/#/#/#/#/#/#           /         \           #/#/#/#/#/#/#/#/#/#/#/#/#/#/#
#\#\#\#\#\#\#\#\#\#\#\#\#\#\#          /           \          #\#\#\#\#\#\#\#\#\#\#\#\#\#\#
#/#/#/#/#/#/#/#/#/#/#/#/#/#/#         /             \         #/#/#/#/#/#/#/#/#/#/#/#/#/#/#
#\#\#\#\#\#\#\#\#\#\#\#\#\#\#        /               \        #\#\#\#\#\#\#\#\#\#\#\#\#\#\#
#/#/#/#/#/#/#/#/#/#/#/#/#/#/#       /                 \       #/#/#/#/#/#/#/#/#/#/#/#/#/#/#
#\#\#\#\#\#\#\#\#\#\#\#\#\#\#      /         E         \      #\#\#\#\#\#\#\#\#\#\#\#\#\#\#
#/#/#/#/#/#/#/#/#/#/#/#/#/#/#     /                     \     #/#/#/#/#/#/#/#/#/#/#/#/#/#/#
#\#\#\#\#\#\#\#\#\#\#\#\#\#\#    /                       \    #\#\#\#\#\#\#\#\#\#\#\#\#\#\#
#/#/#/#/#/#/#/#/#/#/#/#/#/#/#   /                         \   #/#/#/#/#/#/#/#/#/#/#/#/#/#/#
#\#\#\#\#\#\#\#\#\#\#\#\#\#\#  /                           \  #\#\#\#\#\#\#\#\#\#\#\#\#\#\#
#/#/#/#/#/#/#/#/#/#/#/#/#/#/# /                             \ #/#/#/#/#/#/#/#/#/#/#/#/#/#/#
###########################################################################################