##########################################################################    ##################################################################################
#                                                                                                                                                              #
#                                                                                                                                                              #
#                                                                                                                                                              #
#                                                                                                                                                              #
#                                                                                                                                                              #
#                                                                                                                                                              #
#                                                                                                                                                              #
#                                                                                                                                                              #
#                                                                                                                                                              #
#                                                                                                                                                              #
#                                                                                                                                                              #
#                                                                                                                                                              #
#                                                                                                                                                              #
#                                                                                                                                                              #
#                                                                                                                                                              #
#                                                                                                                                                              #
#                                                                                                                                                              #
#                                                                                                                                                              #
#                                                                                                                                                              #
#                                                                                                                                                              #
#                                                                                                                                                              #
#                                                                                                                                                              #
#                                                                                                                                                              #
#                                                                                                                                                              #
#                                                                                                                                                              #
#                                                                                                                                                              #
#                                                                                                                                                              #
#                                                                                                                                                              #
#                                                                                                                                                              #
#                                                                                                                                                              #
#                                                                                                                                                              #
#                                                                                                                                                              #
#                                                                                                                                                              #
#                                                                                                                                                              #
#                                                                                                                                                              #
#                                                                                                                                                              #
#                                                                                                                                                              #
#                                                                                                                                                              #
#                                                                                                                                                              #
#                                                                                                                                                              #
#                                                                                                                                                              #
#                                                                                                                                                              #
################################################################################################################################################################