######################################################################################################################################################## 
######################################################################################################################################################## 
##                                                                                                                                     E              ## 
##  #######################################################   ###########################################################   #######################   ## 
##  #######################################################   ###########################################################   #######################   ## 
##  ###                                                  ##                                                            ##   ###                       ## 
##  ###   ############################################   ##   ######################################################   ##   ###   ##################  ## 
##  ###   ##        ##                                   ##   ##                                                       ##   ###   ##             ###  ## 
##  ###   ##   ##   ##                                   ##   ##   ##                                             ##   ##   ###   ##   ##        ###  ## 
##  ###   ##   ##   ##   ##################################   ##   #################################################   ##   ###   ##   #######   ###  ## 
##  ###   ##   ##   ##   ###                                  ##                   ##                             ##   ##   ###   ##        ##   ###  ## 
##  ###   ##   ##   ##   ###   #################################################   ##   #######################   ##   ##   ###   #######   ##   ###  ## 
##  ###   ##   ##   ##   ###   ##                                            ###   ##                        ##   ##   ##   ###             ##   ###  ## 
##  ###   ##   ##   ##   ###   ##   ######################################   ###   #######################   ##   ##   ##   ##################   ###  ## 
##  ###   ##   ##   ##   ###   ##   ######################################   ###   #######################   ##   ##   ##   ##################   ###  ## 
##  ###   ##   ##   ##   ###   ##                  ##                        ###                             ##   ##   ##                        ###  ## 
#################   ##   ###   #################   ##    #################################################   ##   ##   ##   ##################   ###  ## 
##             ##   ##   ###   ##                  ##    ##                                  ##         ##   ##   ##   ##   ###                  ###  ## 
##                  ##   ###   ##                  ##    ##                                  ##         ##   ##   ##   ##   ###                  ###  ## 
##   #################   ###   ##   #################    ##   ############    ############   ##    ##   ##   ##   ##   ##   ###   ##################  ## 
##                                                       ##   ##                        ##   ##    ##   ##   ##   ##   ##   ###                       ## 
##  ###   ###########################################    ##   ##                        ##   ##    ##   ##   ##   ##   ##   ############################ 
##  ###   ###########################################    ##   ##   ##################   ##   ##    ##   ##   ##   ##   ##   ############################ 
##  ###   ##                                       ##    ##   ##   ##      \ /     ##   ##   ##    ##   ##             ##                             ## 
##  ###   ##   #################################   ##    ##   ##   ##       X      ##   ##   ##    ##   ############################################  ## 
##  ###   ##   #################################   ##    ##   ##   ##      / \     ##   ##   ##    ##   ############################################  ## 
##  ###   ##                                  ##   ##    ##   ##   ##              ##   ##   ##    ##   ##                                       ###  ## 
##  ###   #################################   ##   ##    ##   ##   #######    #######   ##   ##    ##   ##   #################################   ###  ## 
##  ###   ##                   ##             ##   ##    ##   ##                        ##   ##    ##   ##   ##        ##         ##        ##   ###  ## 
##  ###   ##   ##              ##             ##   ##    ##   ##                        ##   ##    ##   ##   ##   ##   ##         ##   ##   ##   ###  ## 
##  ###   ##   #############   ##   ############   ##    ##   ############################   ##    ##   ##   ##   ##   ##   ###   ##   ##   ##   ###  ## 
##  ###   ##   ##        ###   ##   ##        ##   ##    ##                                        ##   ##   ##   ##   ##   ###   ##   ##   ##   ###  ## 
##  ###   ##   ##   ##   ###   ##   ##   ##   ##   ##    ############################################   ##   ##   ##   ##   ###   ##   ##   ##   ###  ## 
##  ###   ##   ##   ##   ###   ##   ##   ##   ##   ##    ############################################   ##   ##   ##   ##   ###   ##   ##   ##   ###  ## 
##  ###   ##   ##   ##   ###   ##   ##   ##   ##   ##                        ###                        ##   ##   ##   ##   ###   ##   ##   ##   ###  ## 
##  ###   ##   ##   ##   ###   ##   ##   ##   ##   ########################  ###   #######################   ##   ##   ##   ###   ##   ##   ##   ###  ## 
##  ###   ##   ##   ##   ###   ##   ##   ##                             ###  ###                             ##   ##   ##   ###        ##   ##   ###  ## 
##  ###   ##   ##   ##   ###   ##   ##   ############################   ###  ##################################   ##   ##   #############   ##   ###  ## 
##  ###   ##   ##   ##   ###   ##   ##   ##        ##                   ###                                  ##   ##   ##              ##   ##   ###  ## 
##  ###   ##        ##   ###   ##   ##             ##                   ###                                       ##   ##                   ##   ###  ## 
##  ###   ############   ###   ##   ############   ##    ######################################################   ##   ##   ##################   ###  ## 
##  ###         E        ###   ##                  ##                                                             ##                    E        ###  ## 
##  ########################   ##   ######################################    ######################################################################  ## 
##  ########################   ##   ######################################    ######################################################################  ## 
##                             ##                                                                                                                     ## 
######################################################################################################################################################## 
######################################################################################################################################################## 