###########################################################################################
#############################\                               /#############################
############################# \                             / #############################
#############################  \                           /  #############################
#############################   \                         /   #############################
#############################    \                       /    #############################
#############################     \                     /     #############################
#############################      \                   /      #############################
#############################       \                 /       #############################
#############################        \               /        #############################
#############################         \             /         #############################
#############################          \           /          #############################
#############################           \         /           #############################
#############################            \       /            #############################
#############################             \     /             #############################
#############################              \   /              #############################
#############################               \ /               #############################
#############################----------------X----------------#############################
#############################               / \               #############################
#############################              /   \              #############################
#############################             /     \             #############################
#############################            /       \            #############################
#############################           /         \           #############################
#############################          /           \          #############################
#############################         /             \         #############################
#############################        /               \        #############################
#############################       /                 \       #############################
#############################      /         E         \      #############################
#############################     /                     \     #############################
#############################    /                       \    #############################
#############################   /                         \   #############################
#############################  /                           \  #############################
############################# /                             \ #############################
#############################/                               \#############################
###########################################################################################